|------------------------------------------------------------------------------|
|                                                                              |
| |------------------------|           |-----------------------|               |
| |........................|           |.......................|               |
| |........................+###########+.......................|-------|       |
| |........................|     #     |...............................|--|    |
| |........................|     #     |..................................|--| |
| |----------+-------------|     #     |----+----------------|...............| |
|            #                 ##############                |...............| |
|            #                 #      |-----+------|         |...............| |
|            #                 #      |............|         |...............| |
|            ###################      |............|    #####+...............| |
|            #                 #      |............|    #    |...............| |
|            #                 #      |-----+------|    #    |--------+------| |
|  |---------+----------|      #            #           #             #        |
|  |....................|      #            #           #        |----+------| |
|  |....................|      ##########################        |...........| |
|  |....................|      #            #                    |...........| |
|  |....................|      #    |-------+--------------------|...........| |
|  |....................|      #    |........................................| |
|  |....................+###########+........................................| |
|  |....................|           |........................................| |
|  |--------------------|           |----------------------------------------| |
|                                                                              |
|------------------------------------------------------------------------------|